###############
    #     #   #
# # # # # ### #
# #   # # #   #
# ##### # # ###
#       # #   #
######### ### #
#       #     #
# ########### #
#         #   #
# ##### ### ###
#     #   # # #
##### ### # # #
#       #      
###############
